67 67 67 67 67 67 67 67 67 67 67 67 67 67 67 67 67 67 67 67
67 67 67 67 67 67 67 00 10 10 10 10 10 10 10 10 10 10 50 67
67 67 67 67 67 67 67 01 11 11 11 11 11 11 11 11 11 11 51 67
67 67 67 67 67 67 67 01 13 13 13 13 13 13 12 61 61 60 51 67
67 67 67 67 67 67 67 01 13 43 13 13 42 13 13 13 60 61 51 67
67 67 67 67 67 67 67 67 12 13 43 13 13 13 13 13 13 13 51 67
67 67 67 67 67 67 67 01 13 13 13 13 13 13 13 13 22 13 51 67
67 67 67 67 67 67 67 01 13 13 43 13 13 13 13 13 13 22 51 67
67 67 67 67 67 67 67 01 13 13 13 13 13 13 13 33 13 13 06 10
67 67 67 67 67 67 67 01 13 12 13 13 32 13 13 13 13 42 11 11
67 67 67 67 67 67 67 01 60 61 13 13 13 13 13 13 32 13 13 33
67 67 67 67 67 67 67 01 61 60 13 42 13 13 13 13 13 13 22 13
67 67 67 67 67 67 67 01 61 60 61 60 13 13 13 33 13 13 13 22
67 67 67 67 67 67 67 04 14 14 14 14 14 14 14 14 14 14 14 14
67 67 67 67 67 67 67 67 67 67 67 67 67 67 67 67 67 67 67 67