67 67 67 67 67 67 67 67 67 67 67 67 67 67 67 67 67 67 67 67
67 67 67 67 67 67 67 00 10 10 10 10 10 10 10 10 10 10 50 67
67 67 67 67 67 67 67 01 11 11 11 11 11 11 11 11 11 11 51 67
67 67 67 67 67 67 67 01 67 67 67 67 67 67 67 67 67 67 51 67
67 67 67 67 67 67 67 01 67 67 67 67 67 67 67 67 67 67 51 67
67 67 67 67 67 67 67 01 67 67 67 67 67 67 67 67 67 67 51 67
67 67 67 67 67 67 67 01 67 67 67 67 67 67 67 67 67 67 51 67
67 67 67 67 67 67 67 01 67 67 67 67 67 67 67 67 67 67 51 67
67 67 67 67 67 67 67 01 67 67 67 67 67 67 67 67 67 67 06 10
67 67 67 67 67 67 67 01 67 67 67 67 67 67 67 67 67 67 11 11
67 67 67 67 67 67 67 67 67 67 67 67 67 67 67 67 67 67 67 67
67 67 67 67 67 67 67 01 67 67 67 67 67 67 67 67 67 67 67 67
67 67 67 67 67 67 67 01 67 67 67 67 67 67 67 67 67 67 67 67
67 67 67 67 67 67 67 04 14 14 14 14 14 14 14 14 14 14 14 14
67 67 67 67 67 67 67 67 67 67 67 67 67 67 67 67 67 67 67 67