67 67 67 67 67 67 67 67 67 67 67 67 67 01 13 13 13 51 67 67
67 67 67 67 67 67 67 67 67 67 67 67 67 01 13 12 13 51 67 67
67 67 67 67 00 10 10 10 10 10 10 10 10 16 32 13 13 51 67 67
67 67 67 67 01 21 11 21 11 21 11 21 11 21 13 13 13 51 67 67
67 67 67 67 01 60 61 61 13 33 13 13 13 13 13 32 13 51 67 67
67 67 67 67 01 60 60 22 13 13 32 13 13 13 13 13 13 51 67 67
67 67 67 67 01 61 13 13 42 13 33 13 12 13 13 22 13 51 67 67
67 67 67 67 01 61 13 13 13 13 13 33 13 13 13 13 13 51 67 67
10 10 10 10 16 13 13 42 13 13 24 02 02 02 02 02 02 06 10 10
21 11 21 11 21 42 12 13 13 13 03 13 22 13 13 13 32 21 11 21
32 13 13 13 13 13 13 13 42 13 03 33 62 13 42 32 62 13 13 32
13 43 13 12 43 13 23 22 13 13 03 42 12 42 13 13 12 13 33 13
43 13 13 42 13 13 12 13 61 61 03 13 43 13 33 32 13 13 13 42
14 14 14 14 14 14 14 14 14 14 14 14 14 14 14 14 14 14 14 14
67 67 67 67 67 67 67 67 67 67 67 67 67 67 67 67 67 67 67 67