67 67 67 67 67 67 67 67 67 67 67 67 67 67 67 67 67 67 67 67
67 67 00 10 10 10 10 10 10 10 10 10 10 10 10 10 10 50 67 67
67 67 01 11 11 11 11 11 11 11 11 11 11 11 11 11 11 51 67 67
67 67 01 33 13 13 13 11 33 13 13 13 11 33 13 13 13 51 67 67
67 67 01 13 13 42 13 11 13 13 13 32 11 13 13 22 13 51 67 67
67 67 01 13 13 13 13 11 13 13 13 13 11 13 13 13 13 51 67 67
67 67 01 13 13 13 32 11 13 42 13 32 11 43 13 13 32 51 67 67
10 10 16 13 33 13 13 11 13 33 13 13 11 13 33 13 13 51 67 67
11 11 11 65 11 11 11 11 65 11 11 11 11 65 11 11 11 51 67 67
13 13 13 13 13 13 13 13 13 22 13 13 13 13 13 13 32 51 67 67
13 43 13 13 22 13 13 12 13 13 13 13 13 32 13 13 13 51 67 67
32 13 13 13 13 43 13 13 13 43 13 13 22 13 13 13 12 51 67 67
14 14 14 14 14 14 14 14 14 14 14 14 14 15 13 13 13 51 67 67
67 67 67 67 67 67 67 67 67 67 67 67 67 01 22 13 13 51 67 67
67 67 67 67 67 67 67 67 67 67 67 67 67 01 13 13 32 51 67 67