67 67 67 67 67 67 67 67 67 67 67 67 67 01 67 67 67 51 67 67
67 67 67 67 67 67 67 67 67 67 00 10 10 16 67 67 67 51 67 67
67 67 67 67 67 67 67 67 00 10 16 11 11 11 67 67 67 51 67 67
67 67 67 67 67 67 67 00 16 11 11 67 67 67 67 67 67 51 67 67
67 67 67 67 67 00 10 16 11 67 67 67 67 67 67 67 67 51 67 67
67 67 67 00 10 16 11 11 67 67 67 67 67 67 67 67 67 51 67 67
67 67 67 01 11 11 67 67 67 67 67 67 67 67 67 67 67 51 67 67
67 00 10 16 67 67 67 67 67 67 67 67 67 67 00 14 14 06 10 10
10 16 11 11 67 67 67 67 67 67 67 67 00 14 16 67 67 11 11 11
11 11 67 67 67 67 67 67 67 67 67 00 16 67 67 67 67 67 67 67
67 67 67 67 67 67 67 67 67 00 14 16 67 67 67 67 67 67 67 67
67 67 67 67 67 67 00 14 14 16 67 67 67 67 67 67 67 67 67 67
67 67 67 67 67 67 01 67 67 67 67 67 67 67 67 67 67 00 14 14
14 14 14 14 14 14 14 14 14 14 14 14 14 14 14 14 14 14 67 67
67 67 67 67 67 67 67 67 67 67 67 67 67 67 67 67 67 67 67 67