67 67 67 67 67 67 67 67 67 67 67 67 67 67 67 67 67 67 67 67
67 67 00 10 10 10 10 10 10 10 10 10 10 10 10 10 10 50 67 67
67 67 01 11 11 11 11 11 11 11 11 11 11 11 11 11 11 51 67 67
67 67 01 67 67 67 67 11 67 67 67 67 11 67 67 67 67 51 67 67
67 67 01 67 67 67 67 11 67 67 67 67 11 67 67 67 67 51 67 67
67 67 01 67 67 67 67 11 67 67 67 67 11 67 67 67 67 51 67 67
67 67 01 67 67 67 67 11 67 67 67 67 11 67 67 67 67 51 67 67
10 10 16 67 67 67 67 11 67 67 67 67 11 67 67 67 67 51 67 67
11 11 11 65 11 11 11 11 65 11 11 11 11 65 11 11 11 51 67 67
67 67 67 67 67 67 67 67 67 67 67 67 67 67 67 67 67 51 67 67
67 67 67 67 67 67 67 67 67 67 67 67 67 67 67 67 67 51 67 67
67 67 67 67 67 67 67 67 67 67 67 67 67 67 67 67 67 51 67 67
14 14 14 14 14 14 14 14 14 14 14 14 14 15 67 67 67 51 67 67
67 67 67 67 67 67 67 67 67 67 67 67 67 01 67 67 67 51 67 67
67 67 67 67 67 67 67 67 67 67 67 67 67 01 67 67 67 51 67 67